 XXXXXXXX    
 X@XX   XXXX 
 X *   *   X 
 X  * * ***X 
 X **X X   X 
XX*    *   X 
X  *  *****XX
X *XXXX X   X
X  *....X   X
X XX....X** X
X XX....   XX
X   ....X  X 
XX X....X**X 
 X X....X  X 
 X         X 
 XXXX XX*XXX 
    X    X   
    XXXXXX   