      XXXX   
  XXXXX  X   
 XX     *X   
XX *  XX XXX 
X@* * X *  X 
XXXX XX   *X 
 X....X* * X 
 X....X   *X 
 X....  ** XX
 X... X *   X
 XXXXXX* *  X
      X   XXX
      X* XXX 
      X  X   
      XXXX   