 XXXXXXXXXXXXXXXXX     
 X...   X    X   XXX   
XX.....  *XX X X * X   
X......X  *  X  *  X   
X......X  X  X X X XX  
XXXXXXXXX *  * X X  XXX
  X     X*XX* XX XX   X
 XX   *    X *  *   X X
 X  XX XXX X  XXXXX*X X
 X * **     *   *     X
 X *    *XX* XXXXXXXX X
 XXXXXXX  @ XX      XXX
       XXXXXX          