XXXXXXXXXXXX
XX     XX  X
XX   *   * X
XXXX XX ** X
X   * X    X
X *** X XXXX
X   X X * XX
X  X  X  * X
X *X *X    X
X   ..X XXXX
XXXX.. * X@X
X.....X *X X
XX....X  * X
XXX..XX    X
XXXXXXXXXXXX