     XXXXXXX   
     X@ X  X   
     X *   X   
    XXX XX X   
 XXXX *  X XX  
 X       X  XX 
 X * *XXXX * X 
 X ** X  X  *X 
 X*  *   X*  X 
XX  **X   ** XX
X **  X  X  * X
X     XXXX *  X
X  X*XX..XX   X
XXX .X....XXXXX
  X .......XX  
  X....   ..X  
  XXXXXXXXXXX  