        XXXXX             
        X   XXXX          
        X *    XXXX  XXXX 
        X   X *X  XXXX  X 
XXXXXXXXXXX X   *   X   X 
X..     X *  XXXX X  X  X 
X..*  X   *  X  * X * .XX 
X.&X X * * XX  XX    X.X  
X..X* @ X   XX    ** X.X  
X..X * *  * * XX   XX .X  
X.&** X XX   * X*X * X.X  
X..X      XX   X     X.X  
X..XXXXXXX  XXX XXXXXX.XX 
X **                  &.XX
X  XXXXXXXXXXXXXXXXXX  ..X
XXXX                XXXXXX