 XXXXXXXXX    
 X....   XX   
 X.X.X  * XX  
XX....X X @XX 
X ....X  X  XX
X     X* XX* X
XX XXX  *    X
 X*  * * *X  X
 X X  * * XX X
 X  XXX  XX  X
 X    XX XX XX
 X  * X  *  X 
 XXX* *   XXX 
   X  XXXXX   
   XXXX       