XXXXXXXXXXXX  XXXXXX
X   X    X@XXXX....X
X   **X       .....X
X   X XXX   XX ....X
XX XX XXX  X   ....X
 X * *     X XX XXXX
 X  * *XX  X       X
XXXX X  XXXX XX XX X
X  X X*   XX XX    X
X *  *  X XX XXXXXXX
X X * *    X X      
X  * XX XX X X      
X **     **  X      
XX XX XXX *  X      
 X    X X    X      
 XXXXXX XXXXXX      