    XXXXXXXXX       
  XXX   XX  XXXXX   
XXX      X  X   XXXX
X  ** X* X  X  ... X
X X  *X@*XX X X.X. X
X  XX X*  X    ... X
X *X    * X X X.X. X
X    XX  XX* * ... X
X * XX   X  X*X.X. X
XX **  *   *  *... X
 X*  XXXXXX    XX  X
 X   X    XXXXXXXXXX
 XXXXX              