 XXXXXXXXXXXXXXXXXXXXX
XX                   X
X    * X      XX X   X
X  XXXXXX XXX  X*XX XX
XX*X   XX*X....   X X 
X  X    * X....XX X X 
X * X X X X....XX   X 
X * X**   X....XX*X X 
X X *@*XX*X....XX   X 
X   ***   X....X    X 
X  *X   X XXXXXX *XXX 
XX  X XXX**  *   * X  
XX     X *  * XX   X  
 XXXXX   X   XXXXXXX  
     XXXXXXXXX        