    XXXXXXXXXXXX 
    X          XX
    X  X X** *  X
    X* X*X  XX @X
   XX XX X * X XX
   X   * X*  X X 
   X   X *   X X 
   XX * *   XX X 
   X  X  XX  * X 
   X    XX **X X 
XXXXXX**   X   X 
X....X  XXXXXXXX 
X.X... XX        
X....   X        
X....   X        
XXXXXXXXX        