    XXXXXXXXX  XXXX   
    X   XX  XXXX  X   
    X   *   X  *  X   
    X  X XX X     XXXX
    XX *   * **X X   X
    XXXX  X  X * *   X
XXXXX  XXXX    XXX...X
X   X* X  X XXXX.....X
X      X  X X XX.....X
XXXXXX X  X*   XXX...X
   X   XX X *X   X...X
  XX       *  *X XXXXX
 XX ***XX  X *   X    
 X   X  X XXX  XXX    
 X   *  X* @XXXX      
 XXXXX  X   X         
     XXXXXXXX         