 XXXXX             
 X   X             
 X X XXXXXX        
 X      *@XXXXXX   
 X * XX* XXX   X   
 X XXXX *    * X   
 X XXXXX X  X* XXXX
XX  XXXX XX*      X
X  *X  *  X XX XX X
X         X X...X X
XXXXXX  XXX  ...  X
     XXXX X X...X X
          X XXX X X
          X       X
          XXXXXXXXX