   XXXXXXXXXX        
   X........XXXX     
   X.X.X....X  X     
   X........** X     
   X     .XXX  XXXX  
 XXXXXXXXX  * X   X  
 X     *   * *  * X  
 X  X    X  * *X  X  
 XX XXXXX   X  X  X  
 X *     X   XXXX X  
XX  *X   X XX  X  X  
X    XX*XXX    X  XX 
X *    * X  X  X   X 
XXXXX    X XX X XX XX
    X*X X  *  * *   X
    X@X  *X***  X   X
    XXX  *      XXXXX
      XX  X  X  X    
       XXXXXXXXXX    