              XXX      
             XX.XXX    
             X....X    
 XXXXXXXXXXXXX....X    
XX   XX     XX....XXXXX
X  **XX  * @XX....    X
X      ** *X  ....X   X
X  * XX ** X X....X  XX
X  * XX *  X XX XXX  X 
XX XXXXX XXX         X 
XX   *  * XXXXX XXX  X 
X *XXX  X XXXXX X XXXX 
X   *   X       X      
X  * X* * *XXX  X      
X ***X *   X XXXX      
X    X  ** X           
XXXXXX   XXX           
     XXXXX             